the	a
after	before
dull	bright
make	destroy
makes	destroys
hands	feet
boy	girl
light	heavy
jack	jill
look	listen
a	many
you	me
many	no
all	none
and	nor
themselves	others
pounds	pennies
work	play
pennies	pounds
will	wont
play	work
no	yes
